Deepak	Mohan	deepmoha@qti.qualcomm.com
Baburaj	Sudhakaran	baburaj@ftdinfocom.com
Dhwani	Desai	dhwadesa@qti.qualcomm.com
Mradul	Gupta	mradgupt@qti.qualcomm.com
Kedar	Ramachandra	kedarama@qti.qualcomm.com
Megha	Agarwal	meghagar@qti.qualcomm.com
Aditya	Singh	adising@qti.qualcomm.com
Kushangi	Varshney	kvarshne@qti.qualcomm.com
anjani	chaurasia	anjachau@qti.qualcomm.com
Battu Balaji	Yadav	bbalajiy@qti.qualcomm.com
Deepika 	R 	rdeepika@qti.qualcomm.com
Tooba Shabnam	Mohd Mukarram	tmohdmuk@qti.qualcomm.com
Sarah	Biju	sbiju@qti.qualcomm.com
Cosmo	Liu	cosmliu@qti.qualcomm.com
Nithya	R	nithyar@qti.qualcomm.com
Raheem	Baig	rbaig@qti.qualcomm.com
Navya	Singla	navysing@qti.qulcomm.com
Muskan	Singla	musksing@qti.qualcomm.com
SWAGATIKA	MAHAPATRA	swagmaha@qti.qualcomm.com
kumar	chandan	kumachan@qti.qualcomm.com
Prateek	Jain	c_pratja@qti.qualcomm.com
Garima	Agarwal	gariagar@qti.qualcomm.com
utkarsh	chaurasia	utkarshchaurasia28@gmail.com
Avishk 	Khare	aviskhar@qti.qualcomm.com
Shabarish 	Babu B V	shabarishbabubv@gmail.com
Aishverya	Sharma	aishvery@qti.qualcomm.com
Nithya 	Rajadurai	nithya.rajadurai@gmail.com
Kousalya	P	kousalya@qti.qualcomm.com
Robinson	Devasia	rdevasia@qti.qualcomm.com
Deepak	Mohan	deepakmohan33@gmail.com
Tasneem	banu	tbanug@qti.qualcomm.com
